M M M M M M M M M M
M P P P P P F R R M
M P P P A P P F F M
M P P P P P P P P M
M P P L P P L P P M
M P P P P P P P P M
M P P P P P P P P M
M P P P P P P P P M
M P P P P P P P D M
M M M M M M M M M M