M M M M M
M D P F M
M R P L M
M A P P M
M M M M M