M M M M M M M M M M
M P P P P P P P F M
M R P P P P P P P M
M P P P P D P P P M
M P P P P P P P P M
M P P P P P P P P M
M P P P A P P P P M
M P P P P P P P L M
M P P P P P P P P M
M M M M M M M M M M